!!!!!!!!!!!!-!!!!!!!!
!!!-!!!!!!!!!!!!!!!!!
!!!!!!!!!!-!!!!!!!!!!
!!!!!-!!!!!!!!!!!-!!!
!!!!!!!!!!!!!!!!!!!!!
+++++++++++++++++++++
#####################
#####################
#####################
#####################
#####################
#####################
#####################
