!!!!!!!!!!!!-!!!!!!!!
!!!-!!!!!!!!!!!!!!!!!
!!!!!!!!!!!!!!!!!!!!!
!!!!!-!!!!!!!!!!!-!!!
!!!!!!!!!!!!!!!!!!!!!
+++++++++++++++++++++
#####################
#####################
#####################
#####################
#####################
#####################
#####################
