rrrrrrrrrrrrrrrrrr
r!!!!!!!!!!!!!!!!r
r!!!!!!!!!!!!!!!!r
r!!!!!!!!!!!!!!!!r
r!!!!!!!!!!!!!!!!r
r!!!!!!!!!!!!!!!!r
r!!!!!!!!!!!!!!!!r
s++++++++++++++++s
c################r
c################r
c################r
c################r
c################r
cccccccccccccccccc
