!!!!!!!!!!!!!!!!!!!!!
!!!!!!!!!!!!!!!!!!!!!
!##!!!!!!!!!!!!!###!!
####!!!!!###!!###!!##
!!##!!!!#####!!!###!!
###!####!!!##!##!!!!!
#####################
#####################
#####################
#####################
#####################
#####################
#####################
