################
#              #
#   ##    ##   #
#   !!    !!   #
#              #
#              #
#  #         # #
#   #########  #
#              #
#              #
#              #
#####!!!!!######
