!!!!!!!!!!!!!!!!!!!!!
!!!!!!!!!!!!!!!!!!!!!
!!!!!!!!!!!!!!!!!!!!!
++!!!!!!!++++!###!!##
!!++!!!!+####!!!###!!
###!++++#####!##!!!!!
#####################
#####################
#####################
#####################
#####################
#####################
#####################
