rrrrrrrnnrrrr-rrrrrrr
r!!-!!!!!!!!!!!!!!!!r
r!!!!!!!!!-!!!!!!!!!r
r!!!!-!!!!!!!!!!!-!!r
r!!!!!!!!!!!!!!!!!!!r
s+++++++++++++++++++s
c###################c
c###################c
c###################c
c###################c
c###################c
c###################c
ccccccccccccccccccccc
