!!!!!!!!!!!!!!!!
!!!!!!!!!!!!!!!!
!##!!!!!!!!!!!!!
####!!!!!###!!##
!!##!!!!#####!!!
###!####!!!##!##
################
################
################
################
################
################
